LEVEL: Introduction
WALLS: FF3319 FFFF33
#########
#.......#
#...@...#
#.......#
#########

#########
#.......#
#...#@..#
#.......#
#########

#########
#.......#
#.#..@#.#
#.......#
#########

WALLS: 1933FF 33FFFF
####
#@.####
#.. ..####
#........#
##########

####    ..
#@.####  .
#.. ..###.
#.....###.
#.........

########
#......#
#.@  ..#
#..  ..#
#......#
########

WALLS: 00FF00 20C030
#####...#   #####
#.......#.......#
#.@.......# .. .#
#.......#   #...#
#########   #####
